Employee_ID,Age,Gender,Marital_Status,Department,Job_Role,Job_Level,Monthly_Income,Hourly_Rate,Years_at_Company,Years_in_Current_Role,Years_Since_Last_Promotion,Work_Life_Balance,Job_Satisfaction,Performance_Rating,Training_Hours_Last_Year,Overtime,Project_Count,Average_Hours_Worked_Per_Week,Absenteeism,Work_Environment_Satisfaction,Relationship_with_Manager,Job_Involvement,Distance_From_Home,Number_of_Companies_Worked,Attrition,Extra_Feature_1,Extra_Feature_2,Extra_Feature_3,Extra_Feature_4,Extra_Feature_5,Extra_Feature_6,Extra_Feature_7,Extra_Feature_8,Extra_Feature_9,Extra_Feature_10,Extra_Feature_11,Extra_Feature_12,Extra_Feature_13,Extra_Feature_14,Extra_Feature_15,Extra_Feature_16,Extra_Feature_17,Extra_Feature_18,Extra_Feature_19,Extra_Feature_20,Extra_Feature_21,Extra_Feature_22,Extra_Feature_23,Extra_Feature_24
1.0,58.0,1.0,15488.0,28.0,15.0,4.0,2.0,1.0,3.0,4.0,14.0,6.0,54.0,17.0,4.0,4.0,4.0,20.0,3.0,2.0,48.0,5.0,13079.0,28.0,6.0,9.0,1.0,2.0,1.0,1.0,6.0,2.0,45.0,1.0,4.0,1.0,2.0,25.0,2.0,3.0,34.0,1.0,13744.0,24.0,24.0,14.0,8.0,3.0,2.0
1.0,77.0,6.0,34.0,2.0,3.0,4.0,4.0,45.0,3.0,4.0,27.0,1.0,6809.0,26.0,10.0,8.0,2.0,3.0,5.0,4.0,49.0,9.0,48.0,18.0,2.0,3.0,1.0,35.0,3.0,5.0,40.0,1.0,10206.0,52.0,29.0,10.0,1.0,2.0,5.0,1.0,64.0,3.0,33.0,0.0,4.0,1.0,3.0,44.0,3.0
6.0,58.0,3.0,16746.0,48.0,15.0,9.0,3.0,4.0,2.0,3.0,66.0,9.0,35.0,9.0,2.0,2.0,3.0,24.0,1.0,7.0,38.0,1.0,18995.0,55.0,29.0,1.0,1.0,4.0,5.0,1.0,43.0,2.0,55.0,13.0,1.0,1.0,3.0,40.0,2.0,8.0,42.0,3.0,19035.0,24.0,4.0,9.0,0.0,3.0,2.0
3.0,30.0,5.0,46.0,12.0,4.0,2.0,4.0,13.0,1.0,9.0,30.0,5.0,14671.0,31.0,18.0,3.0,5.0,4.0,1.0,1.0,42.0,2.0,36.0,8.0,3.0,4.0,2.0,48.0,3.0,10.0,30.0,3.0,16210.0,31.0,18.0,11.0,9.0,3.0,1.0,2.0,76.0,7.0,53.0,5.0,3.0,3.0,4.0,39.0,2.0
11.0,43.0,5.0,8197.0,81.0,25.0,12.0,7.0,3.0,1.0,4.0,47.0,9.0,52.0,5.0,4.0,1.0,2.0,4.0,3.0,12.0,55.0,5.0,18553.0,76.0,17.0,10.0,9.0,2.0,2.0,2.0,81.0,7.0,36.0,18.0,2.0,2.0,3.0,12.0,1.0,13.0,59.0,3.0,10452.0,15.0,12.0,9.0,9.0,4.0,2.0
1.0,80.0,5.0,38.0,9.0,1.0,4.0,1.0,17.0,1.0,14.0,43.0,2.0,11718.0,26.0,7.0,1.0,1.0,2.0,4.0,1.0,80.0,4.0,42.0,2.0,1.0,3.0,4.0,1.0,3.0,15.0,22.0,4.0,17859.0,18.0,16.0,1.0,8.0,3.0,5.0,3.0,60.0,4.0,49.0,17.0,3.0,3.0,1.0,17.0,2.0
16.0,41.0,1.0,5172.0,56.0,11.0,9.0,2.0,3.0,5.0,1.0,74.0,8.0,43.0,18.0,3.0,3.0,3.0,2.0,1.0,17.0,21.0,4.0,16158.0,27.0,14.0,11.0,7.0,3.0,4.0,1.0,83.0,1.0,45.0,4.0,2.0,4.0,2.0,6.0,3.0,18.0,43.0,1.0,19663.0,99.0,3.0,14.0,7.0,1.0,4.0
1.0,9.0,5.0,52.0,10.0,3.0,4.0,1.0,44.0,4.0,19.0,49.0,1.0,14085.0,18.0,19.0,6.0,2.0,1.0,1.0,2.0,28.0,2.0,38.0,9.0,2.0,4.0,4.0,11.0,3.0,20.0,57.0,5.0,6981.0,96.0,18.0,4.0,2.0,1.0,4.0,3.0,47.0,9.0,44.0,16.0,4.0,3.0,1.0,43.0,3.0
21.0,21.0,1.0,8247.0,83.0,10.0,7.0,5.0,2.0,2.0,2.0,97.0,7.0,34.0,3.0,1.0,1.0,1.0,18.0,2.0,22.0,40.0,1.0,13553.0,33.0,6.0,5.0,0.0,3.0,3.0,3.0,80.0,8.0,47.0,17.0,4.0,2.0,4.0,40.0,3.0,23.0,52.0,3.0,9135.0,16.0,13.0,10.0,3.0,4.0,2.0
2.0,61.0,6.0,50.0,17.0,3.0,4.0,2.0,25.0,4.0,24.0,31.0,4.0,8573.0,26.0,10.0,14.0,0.0,2.0,4.0,1.0,12.0,9.0,49.0,0.0,1.0,1.0,4.0,39.0,3.0,25.0,41.0,3.0,16731.0,95.0,18.0,7.0,2.0,2.0,5.0,2.0,43.0,6.0,37.0,13.0,1.0,2.0,3.0,28.0,4.0
26.0,44.0,1.0,10189.0,88.0,26.0,8.0,8.0,2.0,2.0,2.0,46.0,7.0,44.0,7.0,4.0,3.0,2.0,46.0,1.0,27.0,46.0,5.0,17541.0,20.0,20.0,8.0,4.0,4.0,5.0,3.0,63.0,7.0,50.0,1.0,2.0,1.0,1.0,16.0,3.0,28.0,47.0,3.0,13878.0,22.0,26.0,1.0,4.0,3.0,2.0
3.0,90.0,9.0,54.0,18.0,1.0,3.0,4.0,12.0,2.0,29.0,35.0,3.0,14087.0,65.0,16.0,8.0,3.0,1.0,5.0,2.0,52.0,8.0,38.0,14.0,2.0,2.0,3.0,41.0,3.0,30.0,34.0,2.0,16667.0,25.0,25.0,6.0,2.0,3.0,2.0,3.0,89.0,1.0,48.0,1.0,4.0,4.0,4.0,29.0,4.0
31.0,22.0,1.0,5776.0,77.0,25.0,4.0,4.0,3.0,5.0,3.0,91.0,4.0,58.0,3.0,4.0,3.0,2.0,23.0,4.0,32.0,56.0,5.0,12311.0,71.0,6.0,13.0,3.0,2.0,3.0,3.0,76.0,7.0,55.0,0.0,2.0,1.0,3.0,21.0,2.0,33.0,26.0,3.0,10697.0,26.0,13.0,14.0,7.0,2.0,1.0
4.0,75.0,8.0,51.0,18.0,4.0,4.0,1.0,16.0,4.0,34.0,40.0,3.0,17629.0,87.0,4.0,12.0,3.0,2.0,2.0,3.0,43.0,7.0,35.0,9.0,1.0,1.0,2.0,48.0,3.0,35.0,28.0,5.0,11386.0,16.0,23.0,8.0,7.0,1.0,3.0,4.0,27.0,3.0,33.0,0.0,4.0,2.0,3.0,41.0,4.0
36.0,58.0,1.0,11044.0,22.0,14.0,3.0,5.0,1.0,1.0,4.0,1.0,4.0,40.0,19.0,4.0,2.0,2.0,45.0,3.0,37.0,37.0,2.0,12615.0,25.0,1.0,13.0,4.0,1.0,2.0,3.0,56.0,7.0,58.0,14.0,1.0,4.0,1.0,26.0,3.0,38.0,23.0,3.0,18034.0,67.0,28.0,4.0,3.0,3.0,3.0
2.0,56.0,8.0,39.0,3.0,2.0,1.0,3.0,37.0,4.0,39.0,44.0,2.0,8060.0,24.0,20.0,6.0,3.0,2.0,3.0,3.0,33.0,7.0,32.0,6.0,4.0,1.0,4.0,22.0,2.0,40.0,33.0,4.0,13900.0,99.0,5.0,11.0,3.0,4.0,3.0,1.0,86.0,6.0,30.0,6.0,2.0,1.0,4.0,10.0,1.0
41.0,28.0,1.0,8581.0,98.0,8.0,7.0,8.0,3.0,4.0,2.0,57.0,9.0,41.0,17.0,1.0,1.0,1.0,7.0,2.0,42.0,45.0,4.0,5014.0,22.0,12.0,4.0,3.0,1.0,5.0,4.0,51.0,9.0,52.0,12.0,2.0,2.0,3.0,9.0,1.0,43.0,21.0,4.0,15997.0,50.0,2.0,4.0,8.0,4.0,1.0
4.0,28.0,7.0,44.0,9.0,2.0,1.0,1.0,25.0,2.0,44.0,39.0,4.0,13635.0,90.0,12.0,7.0,9.0,4.0,5.0,2.0,34.0,8.0,44.0,7.0,3.0,2.0,1.0,46.0,3.0,45.0,47.0,1.0,16648.0,28.0,5.0,6.0,5.0,2.0,5.0,2.0,74.0,6.0,50.0,9.0,3.0,1.0,2.0,15.0,3.0
46.0,26.0,1.0,10148.0,68.0,22.0,13.0,9.0,4.0,5.0,3.0,47.0,1.0,43.0,13.0,4.0,1.0,4.0,13.0,4.0,47.0,27.0,5.0,17022.0,99.0,5.0,11.0,6.0,1.0,3.0,4.0,32.0,1.0,55.0,13.0,3.0,3.0,1.0,42.0,1.0,48.0,54.0,2.0,8919.0,35.0,13.0,8.0,9.0,2.0,5.0
1.0,74.0,6.0,36.0,19.0,3.0,3.0,2.0,46.0,1.0,49.0,33.0,2.0,18886.0,64.0,9.0,1.0,2.0,4.0,4.0,3.0,72.0,2.0,46.0,10.0,3.0,1.0,1.0,26.0,4.0,50.0,36.0,5.0,9638.0,53.0,10.0,10.0,7.0,2.0,2.0,2.0,77.0,8.0,53.0,5.0,2.0,2.0,1.0,21.0,2.0
51.0,55.0,5.0,7651.0,34.0,1.0,13.0,2.0,4.0,3.0,4.0,8.0,1.0,48.0,0.0,2.0,1.0,1.0,23.0,4.0,52.0,59.0,4.0,3609.0,21.0,3.0,11.0,0.0,3.0,1.0,2.0,47.0,2.0,36.0,18.0,3.0,3.0,4.0,44.0,2.0,53.0,23.0,5.0,10940.0,23.0,18.0,7.0,9.0,3.0,2.0
2.0,66.0,8.0,57.0,6.0,1.0,1.0,3.0,28.0,4.0,54.0,21.0,3.0,13348.0,15.0,12.0,12.0,4.0,1.0,2.0,2.0,92.0,6.0,32.0,17.0,3.0,3.0,4.0,38.0,1.0,55.0,25.0,2.0,6866.0,40.0,29.0,7.0,1.0,3.0,2.0,3.0,82.0,2.0,59.0,2.0,1.0,1.0,2.0,12.0,1.0
56.0,23.0,5.0,19755.0,52.0,3.0,11.0,9.0,3.0,5.0,1.0,35.0,2.0,32.0,19.0,2.0,4.0,3.0,24.0,2.0,57.0,48.0,3.0,19999.0,52.0,26.0,7.0,5.0,3.0,5.0,1.0,95.0,7.0,55.0,10.0,1.0,1.0,2.0,13.0,1.0,58.0,37.0,3.0,5253.0,75.0,25.0,7.0,9.0,4.0,3.0
4.0,70.0,5.0,54.0,4.0,2.0,2.0,1.0,40.0,1.0,59.0,45.0,3.0,7942.0,58.0,29.0,10.0,8.0,4.0,5.0,2.0,91.0,5.0,58.0,18.0,1.0,3.0,3.0,48.0,1.0,60.0,53.0,3.0,15330.0,58.0,9.0,14.0,0.0,2.0,5.0,1.0,43.0,8.0,47.0,1.0,2.0,4.0,2.0,2.0,1.0
61.0,29.0,4.0,3864.0,88.0,26.0,10.0,3.0,4.0,5.0,2.0,81.0,7.0,59.0,3.0,2.0,3.0,1.0,39.0,3.0,62.0,55.0,3.0,4268.0,76.0,2.0,8.0,0.0,3.0,3.0,4.0,59.0,9.0,49.0,9.0,3.0,3.0,2.0,12.0,4.0,63.0,33.0,4.0,10454.0,20.0,3.0,9.0,0.0,4.0,3.0
2.0,62.0,4.0,51.0,1.0,4.0,2.0,2.0,39.0,4.0,64.0,50.0,4.0,16666.0,31.0,14.0,9.0,7.0,1.0,4.0,1.0,4.0,4.0,43.0,7.0,4.0,1.0,4.0,14.0,3.0,65.0,34.0,3.0,15370.0,65.0,4.0,2.0,1.0,2.0,4.0,2.0,86.0,2.0,32.0,0.0,2.0,2.0,1.0,30.0,1.0
66.0,27.0,2.0,8229.0,52.0,25.0,13.0,0.0,2.0,4.0,1.0,85.0,3.0,57.0,5.0,3.0,1.0,4.0,41.0,4.0,67.0,33.0,3.0,19309.0,38.0,19.0,13.0,7.0,4.0,4.0,4.0,89.0,1.0,55.0,10.0,4.0,4.0,3.0,43.0,4.0,68.0,42.0,3.0,7054.0,65.0,13.0,7.0,3.0,3.0,2.0
2.0,75.0,1.0,59.0,9.0,4.0,2.0,1.0,48.0,4.0,69.0,59.0,3.0,3935.0,24.0,7.0,7.0,2.0,2.0,2.0,1.0,39.0,7.0,55.0,12.0,3.0,2.0,4.0,19.0,2.0,70.0,40.0,2.0,15172.0,86.0,12.0,4.0,3.0,1.0,4.0,4.0,18.0,5.0,36.0,0.0,3.0,3.0,4.0,31.0,3.0
71.0,35.0,1.0,13530.0,35.0,3.0,9.0,4.0,1.0,4.0,2.0,46.0,3.0,36.0,1.0,4.0,2.0,3.0,43.0,2.0,72.0,37.0,1.0,18560.0,84.0,23.0,8.0,0.0,2.0,1.0,4.0,64.0,7.0,34.0,2.0,4.0,1.0,2.0,43.0,2.0,73.0,43.0,4.0,19156.0,99.0,23.0,12.0,0.0,3.0,2.0
1.0,66.0,2.0,32.0,8.0,1.0,2.0,2.0,25.0,3.0,74.0,45.0,4.0,19709.0,71.0,9.0,1.0,2.0,3.0,1.0,2.0,90.0,3.0,47.0,4.0,1.0,2.0,2.0,4.0,4.0,75.0,44.0,2.0,12726.0,53.0,2.0,2.0,5.0,4.0,1.0,2.0,17.0,1.0,44.0,9.0,2.0,4.0,3.0,13.0,2.0
76.0,48.0,5.0,10774.0,47.0,29.0,13.0,0.0,4.0,5.0,2.0,49.0,8.0,49.0,9.0,4.0,1.0,4.0,36.0,4.0,77.0,34.0,1.0,4985.0,73.0,22.0,13.0,1.0,2.0,3.0,4.0,29.0,2.0,43.0,11.0,3.0,3.0,1.0,42.0,2.0,78.0,20.0,4.0,17252.0,32.0,9.0,2.0,6.0,4.0,2.0
4.0,65.0,7.0,58.0,17.0,3.0,1.0,3.0,37.0,4.0,79.0,44.0,1.0,7603.0,70.0,12.0,12.0,0.0,4.0,4.0,1.0,4.0,9.0,33.0,0.0,4.0,4.0,2.0,3.0,1.0,80.0,26.0,2.0,18960.0,71.0,12.0,12.0,6.0,4.0,4.0,3.0,92.0,6.0,56.0,2.0,2.0,1.0,2.0,16.0,1.0
81.0,28.0,2.0,12462.0,90.0,15.0,11.0,3.0,1.0,3.0,2.0,96.0,2.0,53.0,4.0,3.0,1.0,1.0,26.0,1.0,82.0,43.0,5.0,17166.0,62.0,2.0,8.0,9.0,4.0,2.0,2.0,41.0,2.0,37.0,16.0,4.0,2.0,3.0,40.0,3.0,83.0,20.0,5.0,10754.0,56.0,18.0,1.0,5.0,2.0,4.0
1.0,83.0,9.0,58.0,7.0,4.0,2.0,2.0,39.0,1.0,84.0,27.0,2.0,17246.0,41.0,13.0,4.0,7.0,3.0,4.0,2.0,93.0,8.0,50.0,16.0,2.0,1.0,3.0,19.0,2.0,85.0,43.0,4.0,7078.0,88.0,14.0,10.0,8.0,4.0,5.0,4.0,4.0,9.0,42.0,8.0,4.0,1.0,4.0,46.0,4.0
86.0,30.0,1.0,15853.0,66.0,5.0,12.0,5.0,3.0,1.0,4.0,49.0,4.0,51.0,5.0,3.0,3.0,3.0,15.0,4.0,87.0,36.0,3.0,7042.0,56.0,26.0,5.0,8.0,4.0,4.0,2.0,84.0,4.0,37.0,16.0,1.0,4.0,4.0,32.0,4.0,88.0,27.0,5.0,19284.0,46.0,10.0,9.0,3.0,2.0,2.0
2.0,57.0,2.0,44.0,7.0,2.0,2.0,1.0,49.0,4.0,89.0,54.0,3.0,17389.0,40.0,12.0,7.0,5.0,1.0,3.0,4.0,78.0,1.0,46.0,6.0,4.0,2.0,4.0,21.0,2.0,90.0,54.0,4.0,5575.0,39.0,10.0,8.0,7.0,2.0,5.0,2.0,83.0,4.0,34.0,6.0,2.0,2.0,4.0,1.0,4.0
91.0,52.0,5.0,9754.0,89.0,24.0,14.0,8.0,1.0,2.0,4.0,7.0,8.0,49.0,14.0,4.0,2.0,1.0,6.0,2.0,92.0,24.0,3.0,4986.0,37.0,11.0,11.0,2.0,4.0,5.0,3.0,30.0,2.0,33.0,6.0,1.0,1.0,2.0,27.0,2.0,93.0,58.0,4.0,18470.0,71.0,25.0,9.0,1.0,4.0,1.0
3.0,11.0,8.0,40.0,7.0,2.0,1.0,1.0,23.0,4.0,94.0,47.0,1.0,8968.0,66.0,2.0,13.0,5.0,1.0,4.0,2.0,20.0,1.0,47.0,8.0,4.0,3.0,3.0,47.0,4.0,95.0,26.0,4.0,10493.0,45.0,5.0,7.0,3.0,2.0,2.0,2.0,93.0,1.0,39.0,14.0,1.0,2.0,1.0,31.0,4.0
96.0,28.0,5.0,7103.0,78.0,7.0,5.0,0.0,2.0,3.0,2.0,61.0,4.0,46.0,1.0,3.0,2.0,3.0,12.0,2.0,97.0,27.0,2.0,5076.0,85.0,6.0,13.0,7.0,1.0,1.0,4.0,90.0,7.0,59.0,6.0,4.0,1.0,2.0,21.0,3.0,98.0,31.0,1.0,5994.0,47.0,22.0,5.0,8.0,4.0,1.0
3.0,89.0,9.0,44.0,14.0,1.0,3.0,3.0,2.0,2.0,99.0,53.0,3.0,6744.0,99.0,23.0,10.0,8.0,1.0,5.0,3.0,32.0,5.0,35.0,17.0,1.0,1.0,1.0,5.0,3.0,100.0,52.0,5.0,17466.0,16.0,3.0,11.0,1.0,4.0,1.0,1.0,25.0,2.0,52.0,17.0,2.0,2.0,1.0,9.0,4.0
101.0,42.0,2.0,17523.0,32.0,13.0,6.0,8.0,1.0,2.0,1.0,89.0,7.0,50.0,9.0,4.0,2.0,2.0,20.0,2.0,102.0,43.0,4.0,8594.0,61.0,3.0,5.0,6.0,4.0,5.0,2.0,99.0,2.0,45.0,17.0,3.0,4.0,1.0,46.0,4.0,103.0,56.0,2.0,10531.0,47.0,26.0,13.0,4.0,1.0,1.0
4.0,39.0,9.0,44.0,0.0,4.0,4.0,2.0,18.0,3.0,104.0,54.0,5.0,10371.0,98.0,25.0,12.0,6.0,3.0,3.0,2.0,64.0,9.0,37.0,6.0,1.0,4.0,2.0,22.0,3.0,105.0,59.0,5.0,17547.0,49.0,24.0,11.0,8.0,4.0,2.0,3.0,58.0,3.0,38.0,2.0,3.0,3.0,1.0,8.0,2.0
106.0,41.0,2.0,6144.0,65.0,21.0,9.0,7.0,2.0,3.0,2.0,14.0,8.0,40.0,13.0,1.0,1.0,4.0,34.0,2.0,107.0,46.0,4.0,16990.0,32.0,6.0,3.0,5.0,1.0,3.0,2.0,0.0,4.0,56.0,11.0,2.0,2.0,3.0,9.0,2.0,108.0,54.0,2.0,17083.0,86.0,11.0,3.0,3.0,2.0,5.0
3.0,10.0,3.0,31.0,13.0,4.0,2.0,4.0,7.0,2.0,109.0,20.0,5.0,19626.0,44.0,28.0,7.0,0.0,1.0,4.0,3.0,54.0,1.0,56.0,3.0,1.0,3.0,2.0,30.0,1.0,110.0,54.0,5.0,10954.0,58.0,26.0,7.0,5.0,2.0,5.0,3.0,1.0,5.0,42.0,12.0,1.0,2.0,3.0,18.0,1.0
111.0,56.0,3.0,10269.0,67.0,17.0,6.0,2.0,2.0,2.0,3.0,64.0,4.0,33.0,15.0,4.0,2.0,4.0,27.0,4.0,112.0,33.0,3.0,10130.0,24.0,10.0,3.0,5.0,1.0,2.0,1.0,94.0,1.0,56.0,15.0,3.0,1.0,1.0,16.0,3.0,113.0,22.0,1.0,9828.0,66.0,12.0,14.0,5.0,1.0,5.0
4.0,43.0,8.0,38.0,4.0,1.0,4.0,4.0,21.0,3.0,114.0,20.0,5.0,11844.0,63.0,17.0,13.0,3.0,2.0,4.0,4.0,15.0,8.0,34.0,19.0,4.0,4.0,3.0,5.0,4.0,115.0,24.0,3.0,17220.0,25.0,4.0,7.0,1.0,2.0,5.0,3.0,21.0,8.0,48.0,5.0,2.0,3.0,3.0,29.0,4.0
116.0,45.0,2.0,9331.0,80.0,2.0,5.0,8.0,2.0,2.0,4.0,17.0,3.0,51.0,5.0,2.0,4.0,3.0,47.0,4.0,117.0,33.0,4.0,16397.0,72.0,11.0,7.0,1.0,4.0,4.0,4.0,46.0,6.0,32.0,17.0,4.0,4.0,3.0,37.0,1.0,118.0,58.0,2.0,13291.0,50.0,7.0,2.0,2.0,4.0,2.0
4.0,80.0,7.0,59.0,5.0,1.0,3.0,4.0,43.0,4.0,119.0,46.0,4.0,13164.0,47.0,2.0,6.0,9.0,3.0,4.0,4.0,29.0,9.0,50.0,6.0,4.0,3.0,1.0,22.0,3.0,120.0,28.0,3.0,13450.0,61.0,26.0,14.0,0.0,4.0,4.0,3.0,9.0,5.0,32.0,15.0,4.0,4.0,1.0,14.0,4.0
121.0,34.0,1.0,5035.0,27.0,18.0,8.0,6.0,4.0,5.0,2.0,98.0,9.0,35.0,8.0,1.0,1.0,3.0,19.0,2.0,122.0,34.0,2.0,14463.0,54.0,21.0,1.0,0.0,1.0,5.0,2.0,57.0,6.0,57.0,12.0,3.0,3.0,1.0,35.0,3.0,123.0,45.0,2.0,10977.0,82.0,4.0,4.0,8.0,3.0,5.0
2.0,61.0,4.0,39.0,11.0,3.0,2.0,4.0,24.0,3.0,124.0,32.0,2.0,15182.0,56.0,8.0,11.0,0.0,3.0,4.0,1.0,84.0,1.0,34.0,18.0,2.0,3.0,1.0,42.0,3.0,125.0,51.0,4.0,3298.0,33.0,20.0,1.0,4.0,4.0,4.0,4.0,79.0,1.0,59.0,0.0,3.0,2.0,2.0,6.0,1.0
126.0,58.0,3.0,3923.0,96.0,14.0,14.0,6.0,1.0,2.0,3.0,5.0,5.0,54.0,7.0,4.0,3.0,1.0,3.0,1.0,127.0,51.0,2.0,16331.0,33.0,12.0,1.0,2.0,1.0,3.0,3.0,66.0,3.0,32.0,3.0,1.0,3.0,3.0,34.0,3.0,128.0,23.0,2.0,9578.0,72.0,22.0,10.0,8.0,3.0,5.0
1.0,40.0,5.0,51.0,18.0,2.0,4.0,1.0,45.0,2.0,129.0,49.0,1.0,7875.0,37.0,21.0,12.0,7.0,1.0,2.0,3.0,42.0,5.0,53.0,4.0,3.0,4.0,1.0,2.0,3.0,130.0,56.0,1.0,15254.0,68.0,27.0,14.0,2.0,2.0,2.0,2.0,84.0,1.0,36.0,16.0,4.0,4.0,1.0,15.0,1.0
131.0,42.0,3.0,13905.0,94.0,18.0,14.0,4.0,4.0,1.0,1.0,76.0,8.0,51.0,2.0,2.0,1.0,1.0,37.0,2.0,132.0,58.0,3.0,16353.0,79.0,11.0,11.0,6.0,2.0,5.0,3.0,17.0,5.0,59.0,18.0,1.0,4.0,2.0,15.0,3.0,133.0,34.0,5.0,18882.0,26.0,29.0,8.0,3.0,3.0,2.0
1.0,57.0,5.0,47.0,0.0,3.0,4.0,4.0,32.0,1.0,134.0,48.0,1.0,12663.0,38.0,28.0,7.0,4.0,3.0,1.0,1.0,59.0,9.0,52.0,0.0,4.0,3.0,3.0,21.0,2.0,135.0,55.0,5.0,3941.0,48.0,8.0,12.0,2.0,1.0,5.0,3.0,87.0,8.0,37.0,19.0,1.0,3.0,3.0,17.0,4.0
136.0,32.0,4.0,4907.0,67.0,2.0,10.0,8.0,1.0,4.0,2.0,26.0,1.0,30.0,8.0,4.0,1.0,1.0,34.0,4.0,137.0,51.0,5.0,7837.0,22.0,25.0,13.0,9.0,3.0,1.0,3.0,67.0,3.0,54.0,4.0,4.0,2.0,4.0,32.0,3.0,138.0,26.0,2.0,16680.0,32.0,15.0,1.0,8.0,3.0,4.0
4.0,21.0,7.0,33.0,6.0,4.0,3.0,1.0,47.0,4.0,139.0,41.0,5.0,8696.0,71.0,9.0,11.0,6.0,2.0,3.0,4.0,23.0,1.0,53.0,5.0,1.0,3.0,2.0,23.0,1.0,140.0,47.0,3.0,19226.0,19.0,19.0,14.0,9.0,2.0,3.0,3.0,39.0,1.0,55.0,16.0,2.0,2.0,4.0,35.0,2.0
141.0,21.0,4.0,16543.0,40.0,20.0,13.0,1.0,1.0,3.0,2.0,73.0,5.0,36.0,16.0,4.0,1.0,4.0,37.0,3.0,142.0,25.0,2.0,15615.0,44.0,8.0,2.0,6.0,2.0,3.0,4.0,65.0,9.0,43.0,12.0,2.0,3.0,4.0,43.0,2.0,143.0,47.0,5.0,4466.0,68.0,25.0,4.0,6.0,1.0,2.0
4.0,39.0,6.0,42.0,11.0,2.0,4.0,4.0,41.0,2.0,144.0,47.0,4.0,3375.0,27.0,19.0,1.0,4.0,1.0,3.0,3.0,5.0,2.0,39.0,3.0,3.0,1.0,1.0,37.0,2.0,145.0,39.0,4.0,3262.0,97.0,5.0,3.0,8.0,4.0,2.0,3.0,17.0,9.0,52.0,7.0,3.0,2.0,2.0,33.0,1.0
146.0,49.0,2.0,14580.0,43.0,11.0,8.0,2.0,1.0,2.0,3.0,80.0,6.0,47.0,4.0,2.0,2.0,4.0,25.0,3.0,147.0,30.0,5.0,13136.0,17.0,15.0,8.0,3.0,2.0,5.0,1.0,86.0,5.0,30.0,4.0,3.0,4.0,3.0,46.0,4.0,148.0,47.0,4.0,10833.0,72.0,8.0,8.0,0.0,3.0,2.0
1.0,29.0,5.0,33.0,12.0,3.0,4.0,3.0,37.0,2.0,149.0,44.0,4.0,4893.0,90.0,19.0,6.0,5.0,3.0,2.0,1.0,20.0,3.0,57.0,10.0,2.0,4.0,2.0,40.0,2.0,150.0,58.0,1.0,11106.0,16.0,23.0,6.0,3.0,2.0,3.0,3.0,61.0,6.0,45.0,7.0,1.0,1.0,3.0,21.0,2.0
151.0,52.0,4.0,14826.0,89.0,27.0,5.0,0.0,3.0,2.0,2.0,9.0,4.0,45.0,7.0,3.0,2.0,1.0,46.0,1.0,152.0,20.0,1.0,4652.0,42.0,8.0,13.0,1.0,1.0,4.0,4.0,12.0,2.0,47.0,0.0,3.0,4.0,1.0,48.0,4.0,153.0,46.0,5.0,3599.0,96.0,26.0,9.0,2.0,3.0,3.0
1.0,75.0,3.0,37.0,12.0,1.0,4.0,2.0,38.0,2.0,154.0,32.0,5.0,11792.0,91.0,27.0,4.0,8.0,2.0,1.0,2.0,8.0,9.0,39.0,4.0,1.0,2.0,4.0,40.0,1.0,155.0,22.0,5.0,6637.0,90.0,19.0,10.0,7.0,3.0,3.0,3.0,67.0,9.0,45.0,7.0,1.0,3.0,3.0,34.0,1.0
156.0,58.0,3.0,13355.0,16.0,18.0,12.0,6.0,1.0,2.0,1.0,38.0,6.0,52.0,16.0,2.0,1.0,3.0,19.0,2.0,157.0,25.0,5.0,18989.0,21.0,10.0,12.0,3.0,1.0,4.0,3.0,23.0,9.0,53.0,12.0,1.0,3.0,2.0,27.0,2.0,158.0,27.0,4.0,12290.0,40.0,29.0,12.0,0.0,2.0,3.0
2.0,33.0,4.0,40.0,8.0,2.0,4.0,2.0,9.0,1.0,159.0,46.0,2.0,8599.0,90.0,7.0,7.0,7.0,2.0,4.0,1.0,60.0,5.0,35.0,1.0,4.0,1.0,3.0,5.0,1.0,160.0,28.0,1.0,17342.0,30.0,28.0,1.0,3.0,2.0,1.0,1.0,40.0,6.0,30.0,18.0,4.0,3.0,4.0,5.0,2.0
161.0,56.0,3.0,16945.0,37.0,9.0,9.0,2.0,4.0,1.0,1.0,4.0,9.0,59.0,19.0,1.0,2.0,2.0,25.0,1.0,162.0,52.0,5.0,13762.0,54.0,1.0,7.0,8.0,4.0,5.0,1.0,78.0,5.0,58.0,16.0,1.0,4.0,1.0,26.0,1.0,163.0,43.0,5.0,17312.0,74.0,19.0,10.0,9.0,1.0,5.0
2.0,49.0,8.0,58.0,6.0,4.0,1.0,3.0,19.0,2.0,164.0,34.0,2.0,10382.0,87.0,5.0,12.0,3.0,4.0,3.0,1.0,3.0,1.0,41.0,2.0,2.0,1.0,2.0,30.0,2.0,165.0,51.0,2.0,11982.0,46.0,19.0,9.0,3.0,4.0,5.0,4.0,50.0,5.0,54.0,18.0,2.0,1.0,2.0,36.0,3.0
166.0,51.0,3.0,10707.0,29.0,1.0,7.0,8.0,3.0,4.0,4.0,51.0,1.0,35.0,18.0,1.0,1.0,2.0,48.0,4.0,167.0,43.0,1.0,7633.0,27.0,15.0,2.0,1.0,4.0,5.0,3.0,38.0,6.0,57.0,8.0,1.0,4.0,3.0,48.0,2.0,168.0,31.0,5.0,12269.0,19.0,16.0,6.0,4.0,3.0,4.0
1.0,7.0,7.0,42.0,9.0,1.0,4.0,1.0,16.0,2.0,169.0,58.0,3.0,16778.0,89.0,23.0,10.0,3.0,2.0,5.0,4.0,44.0,5.0,55.0,13.0,4.0,2.0,1.0,7.0,2.0,170.0,21.0,4.0,10008.0,88.0,7.0,12.0,8.0,3.0,5.0,4.0,87.0,1.0,46.0,17.0,3.0,2.0,3.0,18.0,4.0
171.0,22.0,4.0,18523.0,66.0,26.0,11.0,4.0,3.0,5.0,4.0,27.0,6.0,30.0,14.0,1.0,2.0,2.0,21.0,3.0,172.0,56.0,3.0,6618.0,91.0,12.0,4.0,8.0,2.0,2.0,2.0,26.0,5.0,37.0,0.0,2.0,3.0,3.0,31.0,1.0,173.0,36.0,5.0,3272.0,55.0,8.0,3.0,8.0,2.0,2.0
1.0,64.0,6.0,51.0,5.0,3.0,2.0,3.0,1.0,4.0,174.0,21.0,3.0,16007.0,67.0,5.0,2.0,1.0,1.0,5.0,2.0,33.0,7.0,37.0,14.0,2.0,4.0,2.0,3.0,2.0,175.0,21.0,5.0,5547.0,64.0,10.0,6.0,8.0,1.0,4.0,2.0,80.0,7.0,53.0,5.0,3.0,3.0,3.0,31.0,2.0
176.0,47.0,2.0,6164.0,29.0,28.0,8.0,2.0,1.0,3.0,4.0,61.0,2.0,40.0,17.0,4.0,4.0,4.0,25.0,3.0,177.0,42.0,3.0,17414.0,21.0,21.0,6.0,3.0,1.0,1.0,4.0,61.0,3.0,43.0,0.0,3.0,3.0,1.0,8.0,3.0,178.0,56.0,5.0,17327.0,54.0,5.0,9.0,0.0,3.0,2.0
3.0,37.0,6.0,53.0,2.0,2.0,2.0,4.0,1.0,3.0,179.0,51.0,3.0,18576.0,42.0,17.0,14.0,0.0,3.0,5.0,1.0,25.0,3.0,39.0,16.0,3.0,2.0,4.0,7.0,1.0,180.0,52.0,3.0,3946.0,46.0,26.0,5.0,0.0,1.0,1.0,1.0,23.0,2.0,44.0,15.0,4.0,2.0,4.0,7.0,4.0
181.0,20.0,5.0,17693.0,29.0,5.0,2.0,8.0,4.0,2.0,4.0,38.0,4.0,36.0,7.0,2.0,3.0,3.0,8.0,4.0,182.0,38.0,5.0,19890.0,99.0,22.0,8.0,7.0,1.0,3.0,4.0,20.0,5.0,36.0,16.0,1.0,4.0,2.0,19.0,3.0,183.0,21.0,1.0,18540.0,84.0,15.0,9.0,4.0,4.0,4.0
1.0,93.0,9.0,39.0,7.0,3.0,1.0,3.0,17.0,1.0,184.0,45.0,3.0,9719.0,79.0,13.0,14.0,4.0,2.0,5.0,3.0,46.0,3.0,33.0,16.0,2.0,4.0,1.0,11.0,4.0,185.0,51.0,4.0,11435.0,18.0,28.0,10.0,8.0,3.0,3.0,4.0,47.0,3.0,54.0,8.0,3.0,2.0,3.0,47.0,2.0
186.0,25.0,3.0,14350.0,25.0,1.0,4.0,2.0,3.0,2.0,3.0,12.0,6.0,57.0,11.0,4.0,3.0,3.0,41.0,2.0,187.0,51.0,3.0,6590.0,40.0,11.0,6.0,2.0,4.0,5.0,2.0,2.0,5.0,47.0,18.0,2.0,3.0,3.0,49.0,2.0,188.0,23.0,5.0,13064.0,75.0,23.0,11.0,6.0,1.0,1.0
4.0,31.0,6.0,56.0,3.0,1.0,2.0,3.0,11.0,4.0,189.0,30.0,3.0,3390.0,51.0,1.0,10.0,8.0,3.0,4.0,2.0,34.0,7.0,54.0,10.0,1.0,3.0,4.0,38.0,3.0,190.0,36.0,3.0,15668.0,37.0,11.0,8.0,5.0,4.0,2.0,4.0,18.0,3.0,39.0,3.0,3.0,2.0,2.0,41.0,2.0
191.0,57.0,4.0,14569.0,99.0,18.0,9.0,1.0,2.0,4.0,2.0,13.0,5.0,48.0,13.0,4.0,4.0,1.0,2.0,3.0,192.0,43.0,5.0,16029.0,54.0,18.0,12.0,0.0,2.0,5.0,4.0,47.0,8.0,43.0,13.0,4.0,3.0,1.0,4.0,1.0,193.0,24.0,3.0,16107.0,91.0,21.0,5.0,1.0,3.0,3.0
3.0,85.0,4.0,42.0,5.0,3.0,1.0,1.0,28.0,2.0,194.0,53.0,2.0,5560.0,37.0,26.0,12.0,0.0,1.0,4.0,3.0,80.0,2.0,44.0,16.0,2.0,3.0,3.0,33.0,1.0,195.0,25.0,1.0,8867.0,30.0,16.0,6.0,9.0,4.0,1.0,3.0,67.0,4.0,45.0,1.0,2.0,2.0,1.0,11.0,3.0
196.0,41.0,4.0,18284.0,75.0,13.0,11.0,9.0,3.0,2.0,2.0,44.0,2.0,31.0,7.0,3.0,1.0,4.0,3.0,4.0,197.0,30.0,3.0,4211.0,82.0,7.0,4.0,8.0,2.0,1.0,3.0,18.0,3.0,58.0,3.0,2.0,2.0,2.0,40.0,3.0,198.0,35.0,2.0,12121.0,94.0,1.0,5.0,9.0,1.0,4.0
2.0,63.0,4.0,33.0,9.0,2.0,3.0,3.0,5.0,2.0,199.0,52.0,3.0,4539.0,45.0,26.0,7.0,7.0,4.0,3.0,4.0,65.0,4.0,50.0,6.0,2.0,1.0,3.0,21.0,2.0,200.0,28.0,3.0,11693.0,67.0,16.0,9.0,6.0,3.0,3.0,2.0,78.0,9.0,47.0,3.0,3.0,1.0,4.0,22.0,3.0
201.0,25.0,5.0,11921.0,39.0,1.0,10.0,2.0,4.0,1.0,4.0,65.0,6.0,58.0,15.0,1.0,3.0,1.0,37.0,2.0,202.0,35.0,5.0,13310.0,58.0,17.0,11.0,7.0,1.0,5.0,1.0,74.0,9.0,46.0,13.0,4.0,1.0,3.0,11.0,2.0,203.0,48.0,5.0,15744.0,26.0,6.0,13.0,1.0,1.0,5.0
1.0,44.0,4.0,39.0,15.0,1.0,4.0,3.0,44.0,1.0,204.0,22.0,2.0,7386.0,23.0,2.0,6.0,1.0,2.0,3.0,1.0,86.0,9.0,56.0,8.0,2.0,1.0,4.0,22.0,4.0,205.0,39.0,3.0,15242.0,26.0,17.0,14.0,9.0,1.0,1.0,2.0,73.0,9.0,50.0,3.0,3.0,1.0,4.0,41.0,3.0
206.0,55.0,1.0,17257.0,83.0,6.0,6.0,2.0,3.0,1.0,1.0,66.0,6.0,38.0,5.0,4.0,4.0,1.0,13.0,1.0,207.0,38.0,4.0,11947.0,68.0,14.0,8.0,6.0,4.0,1.0,1.0,68.0,5.0,44.0,0.0,2.0,2.0,2.0,3.0,2.0,208.0,45.0,5.0,16946.0,68.0,18.0,11.0,0.0,1.0,4.0
1.0,2.0,3.0,57.0,6.0,4.0,2.0,2.0,13.0,1.0,209.0,22.0,5.0,8930.0,42.0,6.0,4.0,7.0,1.0,5.0,4.0,37.0,5.0,41.0,0.0,4.0,4.0,1.0,28.0,4.0,210.0,38.0,3.0,8402.0,70.0,10.0,3.0,6.0,3.0,5.0,3.0,76.0,3.0,50.0,18.0,1.0,1.0,2.0,11.0,3.0
211.0,39.0,3.0,19017.0,83.0,24.0,14.0,3.0,4.0,4.0,2.0,41.0,5.0,57.0,7.0,2.0,3.0,4.0,11.0,4.0,212.0,51.0,2.0,3507.0,91.0,18.0,7.0,4.0,4.0,2.0,1.0,82.0,5.0,56.0,2.0,4.0,4.0,4.0,21.0,4.0,213.0,26.0,2.0,4436.0,72.0,27.0,5.0,9.0,2.0,4.0
4.0,39.0,2.0,55.0,0.0,1.0,3.0,4.0,21.0,1.0,214.0,52.0,5.0,14618.0,92.0,9.0,2.0,0.0,2.0,1.0,3.0,49.0,9.0,38.0,0.0,3.0,2.0,2.0,7.0,1.0,215.0,59.0,3.0,11750.0,89.0,8.0,2.0,3.0,4.0,4.0,3.0,34.0,7.0,43.0,6.0,4.0,4.0,2.0,17.0,4.0
216.0,58.0,1.0,19122.0,56.0,28.0,11.0,0.0,3.0,1.0,3.0,23.0,6.0,42.0,12.0,2.0,3.0,3.0,48.0,2.0,217.0,37.0,4.0,10354.0,52.0,10.0,6.0,0.0,3.0,3.0,4.0,87.0,5.0,57.0,0.0,3.0,1.0,3.0,14.0,3.0,218.0,59.0,3.0,14294.0,82.0,17.0,8.0,9.0,2.0,1.0
1.0,16.0,4.0,55.0,15.0,4.0,4.0,3.0,33.0,2.0,219.0,20.0,3.0,16840.0,67.0,23.0,1.0,0.0,1.0,5.0,3.0,39.0,8.0,35.0,13.0,4.0,3.0,2.0,11.0,2.0,220.0,30.0,2.0,7399.0,47.0,29.0,11.0,6.0,3.0,4.0,4.0,73.0,2.0,48.0,3.0,2.0,4.0,3.0,13.0,3.0
221.0,47.0,4.0,8037.0,85.0,26.0,6.0,6.0,1.0,1.0,4.0,65.0,8.0,33.0,11.0,4.0,4.0,4.0,1.0,1.0,222.0,44.0,5.0,18848.0,70.0,6.0,12.0,3.0,3.0,2.0,2.0,43.0,1.0,49.0,11.0,2.0,2.0,2.0,34.0,2.0,223.0,42.0,3.0,6715.0,86.0,14.0,2.0,1.0,4.0,3.0
4.0,22.0,1.0,46.0,16.0,2.0,2.0,1.0,9.0,1.0,224.0,50.0,5.0,17877.0,65.0,22.0,2.0,2.0,2.0,2.0,3.0,5.0,3.0,48.0,14.0,2.0,1.0,2.0,13.0,3.0,225.0,49.0,3.0,10837.0,88.0,22.0,7.0,7.0,1.0,2.0,3.0,65.0,5.0,32.0,9.0,2.0,2.0,3.0,37.0,2.0
226.0,54.0,5.0,4301.0,57.0,6.0,10.0,7.0,1.0,2.0,4.0,20.0,6.0,58.0,2.0,4.0,2.0,2.0,30.0,1.0,227.0,26.0,4.0,10370.0,29.0,26.0,1.0,5.0,4.0,3.0,3.0,34.0,4.0,43.0,19.0,3.0,2.0,3.0,41.0,1.0,228.0,35.0,2.0,9411.0,52.0,7.0,6.0,9.0,3.0,3.0
4.0,28.0,7.0,46.0,19.0,3.0,3.0,3.0,45.0,2.0,229.0,45.0,4.0,9365.0,29.0,12.0,14.0,8.0,1.0,3.0,3.0,6.0,7.0,42.0,11.0,1.0,4.0,1.0,37.0,3.0,230.0,21.0,1.0,18449.0,19.0,3.0,7.0,8.0,3.0,3.0,2.0,92.0,2.0,38.0,0.0,2.0,2.0,1.0,47.0,4.0
231.0,20.0,2.0,3692.0,97.0,14.0,14.0,3.0,4.0,2.0,1.0,52.0,2.0,56.0,0.0,4.0,3.0,4.0,7.0,1.0,232.0,31.0,4.0,4478.0,68.0,22.0,8.0,0.0,2.0,5.0,2.0,36.0,2.0,30.0,9.0,4.0,4.0,3.0,14.0,3.0,233.0,24.0,1.0,9396.0,65.0,19.0,7.0,0.0,1.0,5.0
2.0,22.0,2.0,54.0,17.0,1.0,2.0,2.0,48.0,2.0,234.0,56.0,3.0,11448.0,24.0,23.0,6.0,9.0,3.0,3.0,1.0,96.0,9.0,46.0,14.0,3.0,2.0,1.0,6.0,1.0,235.0,51.0,3.0,13622.0,26.0,16.0,9.0,4.0,1.0,4.0,3.0,7.0,5.0,45.0,1.0,4.0,4.0,1.0,34.0,1.0
236.0,28.0,5.0,19825.0,18.0,7.0,13.0,1.0,3.0,1.0,1.0,75.0,8.0,47.0,16.0,1.0,3.0,3.0,16.0,1.0,237.0,54.0,2.0,13073.0,32.0,8.0,3.0,5.0,3.0,4.0,4.0,47.0,5.0,31.0,7.0,3.0,3.0,2.0,37.0,3.0,238.0,38.0,3.0,5646.0,94.0,18.0,11.0,6.0,3.0,4.0
1.0,9.0,5.0,43.0,8.0,4.0,1.0,1.0,36.0,1.0,239.0,35.0,2.0,8209.0,50.0,25.0,6.0,0.0,4.0,4.0,2.0,78.0,1.0,51.0,19.0,2.0,4.0,1.0,46.0,1.0,240.0,22.0,3.0,9533.0,39.0,13.0,4.0,5.0,2.0,5.0,1.0,23.0,6.0,52.0,10.0,1.0,1.0,2.0,6.0,2.0
241.0,39.0,5.0,10211.0,90.0,21.0,2.0,7.0,1.0,1.0,3.0,89.0,4.0,56.0,5.0,4.0,3.0,1.0,8.0,1.0,242.0,43.0,4.0,12927.0,50.0,9.0,1.0,4.0,2.0,4.0,2.0,46.0,3.0,46.0,13.0,1.0,2.0,2.0,24.0,3.0,243.0,52.0,5.0,14927.0,81.0,10.0,12.0,6.0,3.0,3.0
4.0,52.0,6.0,32.0,0.0,1.0,1.0,3.0,3.0,2.0,244.0,43.0,1.0,12316.0,23.0,21.0,12.0,9.0,3.0,5.0,3.0,38.0,2.0,31.0,6.0,1.0,3.0,1.0,4.0,4.0,245.0,30.0,3.0,15177.0,75.0,23.0,14.0,5.0,2.0,3.0,2.0,66.0,8.0,37.0,8.0,2.0,3.0,3.0,32.0,2.0
246.0,27.0,1.0,13846.0,67.0,27.0,1.0,3.0,2.0,3.0,4.0,65.0,1.0,54.0,10.0,3.0,2.0,2.0,1.0,1.0,247.0,55.0,1.0,10933.0,32.0,9.0,11.0,6.0,1.0,4.0,3.0,5.0,9.0,58.0,15.0,3.0,4.0,3.0,34.0,4.0,248.0,57.0,2.0,8476.0,57.0,15.0,10.0,9.0,3.0,3.0
4.0,20.0,8.0,31.0,18.0,4.0,3.0,3.0,45.0,2.0,249.0,59.0,3.0,16853.0,49.0,20.0,3.0,8.0,2.0,1.0,1.0,72.0,1.0,31.0,1.0,2.0,1.0,3.0,9.0,1.0,250.0,39.0,1.0,10928.0,77.0,2.0,4.0,9.0,4.0,3.0,1.0,73.0,9.0,55.0,14.0,3.0,2.0,4.0,12.0,2.0
251.0,54.0,4.0,5080.0,92.0,25.0,2.0,9.0,3.0,4.0,4.0,35.0,2.0,38.0,2.0,4.0,4.0,2.0,10.0,3.0,252.0,44.0,1.0,9089.0,18.0,13.0,13.0,6.0,3.0,3.0,1.0,2.0,3.0,59.0,3.0,4.0,4.0,2.0,10.0,1.0,253.0,54.0,4.0,10797.0,55.0,2.0,12.0,4.0,1.0,5.0
